####################################
#S#  ##  #######    #              #
# #####     #       #  ## ###  #   #
#       ### ## ######  ## #####  ###
### #  #     #      #  ##     #### #
#   #  # #     ####    #  ###     E#
####################################